NO ./assets/bluestone.xpm
SO ./assets/bluestone.xpm
WE ./assets/bluestone.xpm
EA ./assets/bluestone.xpm


F  184,113,39
C 51,198,25















    11111    1111111  1    11111111111111
    011111111100000N00000000000011111111
        1010110000011100000000000111111
11111111111110111000000100011111111
11111111000001111100000010001
       1000001 100000001100011111111
    11110000111101000N00000011111
11111111111111111100111111111
11111111111111111100111111111
10000000111100010000000001001
100000001  100110101110000001
100000001N1110000001 10100001
111111111 1111111111 11111111