NO     ./assets/bluestone.xpm

SO       ./assets/eagle.xpm

WE ./assets/floor_1.xpm

EA ./assets/purplestone.xpm


F 226,100,55

C 55,30,9

11111111111111111111111111111
10000000000000000000000000001
10000000000100000000000010001
10010000000000000000000010001
10000000000100000000000010001
10000000000000000001000000001
10000000000000000000000010001
11110000000001011101010010001
11000000110101011100000010001
10000000000000001100000010001
10000000000000001101010010001
11000000110101000000000000001
11110111110101000000000000001
10000000001100000100000010001
10000000000000001010000101001
10000000000000010000000001001
10000000000000000000N00000001
10000000000000000000000000001
10000000000000000000000000001
10000000000000000000000000001
10000000000000000000000000001
10000000000000000000000000001
10000000000000000000000000001
10000000000000000000000000001
10000000000000000000000000001
10000000000100000001010000001
11111111111111111111111111111
11111111111111111111111111111