
NO     ./assets/bluestone.xpm

SO       ./assets/eagle.xpm

WE ./assets/floor_1.xpm

EA ./assets/purplestone.xpm

F        226 , 100,33

C        255 , 30, 0






  1111111111111111111111111
1N000000001100000000000001
10110001001110000000000001
100100000000000000000000111111111
111111111011000001110000000000001
100000000011000001110111111111111
11110111111111011100000010001
1111111111111111111111111111
11110111111111011101010010001
11000000110101011100000010001
10000000000000001100000010001
10000000000000001101010010001
110000011101010111110111100111
11110111 1110101 10111101001
11111111 1111111 1111111111111